111111111111111
1PSSSSSSSSSSSC1
101010101010101
10S0S0S0S0S0S01
101010101010101
10S0S0S0S0S0S01
101010101010101
10S0S0S0S0S0S01
101010101010101
10S0S0S0S0S0S01
101010101010101
10S0S0S0S0S0SE1
111111111111111