111111111111111
1PSSSSSSSCBBBC1
1010101C101B101
10S0S0S0S0S0B01
101010101010101
10S0S0S0S0S0S01
10101C10101B101
10SBS0S0SBBBB01
1010101B1B1B101
10S0SCSBS0SBC01
1B1B101B101B1B1
10S0S0S0S0S0SE1
111111111111111